Jo|Happy|Emotion
Tri|Sad|Emotion
Ra|Angry|Emotion
Pa|Peaceful|Emotion
Gran|Big|Adjective
Peti|Small|Adjective
Rap|Fast|Adjective
Len|Slow|Adjective
Oc|Eye|Body Part
Man|Hand|Body Part
Ped|Foot|Body Part
Cor|Heart|Body Part
Sonri|Smile|Body Part
Ma|Mother|Family
Pa|Father|Family
Ki|Child|Family
Ami|Friend|Family
Man|Eat|Verb
Bev|Drink|Verb
Dor|Sleep|Verb
Am|Love|Verb
Arb|Tree|Nature and Environment
Aq|Water|Nature and Environment
Mon|Mountain|Nature and Environment
Mar|Sea|Nature and Environment
Prad|Meadow|Nature and Environment
Dom|House|Everyday Objects
Lib|Book|Everyday Objects
Tel|Phone|Everyday Objects
Aut|Car|Everyday Objects
Libtel|Book-phone|Compound Example
Rapaut|Fast-car|Compound Example
Granarb|Big-tree|Compound Example
Pedgo|Foot-go|Compound Example
Comp|Computer|Technology
Net|Internet|Technology
Cam|Camera|Technology
Vid|Video|Technology
Muzi|Music|Technology
Sol|Sun|Nature and Environment
Plu|Rain|Nature and Environment
Ven|Wind|Nature and Environment
Ne|Snow|Nature and Environment
Lab|Work|Activity
Lud|Play|Activity
Stu|Study|Activity
Via|Travel|Activity
Cam|Shirt|Clothing
Pan|Pants|Clothing
Sca|Shoes|Clothing
Pan|Bread|Food
Cas|Cheese|Food
Fru|Fruit|Food
Car|Meat|Food
Lux|Light|Nouns/Adjectives
Dark|Noc|Nouns/Adjectives
Frig|Cold|Nouns/Adjectives
Cal|Hot|Nouns/Adjectives
Nom|Name|Nouns/Adjectives
